111111111111111111111111111111
1E00C0000000000000000000000001
100111111100000000000000000001
100111111000000000000000000001
100100PC1000000000000000000001
100100C01000011111111111000001
100111111000000000000000000001
100010000000000000000000000001
100000000000000000000000000001
111111111111111111111111111111
