111111111111111111111111111111
1E0PC0000000000000000000000001
100111111100000000000000000001
100000000000000000000000000001
100000000000000000000000000001
100000000000011111111111000001
100010000000000000000000000001
100010000000000000000000000001
100000000000000000000000000001
111111111111111111111111111111
