11111111111111111111111111111
1E000000000000000000000000001
100111111100000000000C0000001
10000000000000000000000000001
1000P00C000000000000000000001
10000000000001111111111100001
10001000000000000000000000001
1000100C0000C000C000C00000001
10000000000000000000000000001
11111111111111111111111111111
