11111111111111111111111111111111
1000001110000C000000000110011001
100C1111111000000001000000M00001
10000000000000000001000000000001
10000000000C00000001000000E00001
1000M000000000000001000000000001
10000001100000000001000000P00001
10C00011110000000001000000000001
10000000000000000001000000000001
1000C000000000000000000000000001
11111111111111111111111111111111
