111111111111111111111111111111
1000C0000000000000000000000001
100111111100000000000000000001
100000000000000000000000000001
1000000C0000000000000000000001
1000000C0000011111111111000001
100010000000000000000000000001
100010000000000000000000000001
100000000000000000000000000001
111111111111111111111111111111
