111111111111111111111111111111
1E0000000000000000000000000001
100111111100000000000C00000001
100000000000000000000000000001
1000000C0000000000000000000001
100000000000011111111111000001
100000000000000000000000000001
1000000C0000C000C000C000000001
1000000000000000000000000000P1
111111111111111111111111111111
