111111111111111111111111111111
1E0C000000000000000000000000E1
100111111100000000000000000001
100000000000000000000000000001
100000PC0000000000000000000001
1000000C0000011111111111000001
100010000000000000000000000001
100010000000000000000000000001
100000000000000000000000000001
111111111111111111111111111111
