11111
10C01
100E1
1P001
11111
